20 20
0 0
5 6 6 6 6 6 6 6 6 6 6 6 6 6 6 6 6 6 6 7 
4 4 2 2 1 1 3 3 0 0 0 0 0 3 3 1 1 2 2 4
4 4 2 2 1 1 3 3 0 0 0 0 0 3 3 1 1 2 2 4
2 2 2 2 1 1 1 1 3 3 3 3 3 1 1 1 1 2 2 2
1 1 1 1 1 1 1 1 1 1 1 1 1 1 1 1 1 1 1 1
2 2 2 2 2 2 2 2 4 4 4 4 2 2 2 2 2 2 2 2 
2 2 2 2 2 2 2 2 8 9 10 11 12 2 2 2 2 2 2 2
1 1 1 1 1 1 1 1 1 1 1 1 1 1 1 1 1 1 1 1 
1 1 1 1 1 1 1 1 1 1 1 1 1 1 1 1 1 1 1 1
2 2 2 2 2 2 2 2 2 2 2 2 2 2 2 2 2 2 2 2
4 4 4 4 4 4 4 4 4 4 4 4 4 4 4 4 4 4 4 4
1 1 1 1 1 1 1 1 1 1 1 1 1 1 1 1 1 1 1 1
2 2 2 2 1 1 1 1 3 3 3 3 3 1 1 1 1 2 2 2
4 4 2 2 1 1 3 3 0 0 0 0 0 3 3 1 1 2 2 4
4 4 2 2 1 1 3 3 0 0 0 0 0 3 3 1 1 2 2 4
4 4 2 2 1 1 3 3 0 0 0 0 0 3 3 1 1 2 2 4
4 4 2 2 1 1 3 3 0 0 0 0 0 3 3 1 1 2 2 4
4 4 2 2 1 1 3 3 0 0 0 0 0 3 3 1 1 2 2 4
4 4 2 2 1 1 3 3 0 0 0 0 0 3 3 1 1 2 2 4
2 2 2 2 1 1 1 1 3 3 3 3 3 1 1 1 1 2 2 2
5 6 6 6 6 6 6 6 6 6 6 6 6 6 6 6 6 6 6 7 